(None) mapchip\StageSetTile.png
128
52 22
22
52 1 1 1 1 1 1 1 1 9 0 0 0 0 0 0 0 0 0 0 0 0 0 0 0 0 0 0 0 0 0 0 0 0 0 0 0 0 0 0 0 0 0 0 8 1 1 1 1 1 1 1 1
52 1 1 1 1 1 1 1 1 9 0 0 0 0 0 0 0 0 0 0 0 0 0 0 0 0 0 0 0 0 0 0 0 0 0 0 0 0 0 0 0 0 0 0 8 1 1 1 1 1 1 1 1
52 1 1 1 1 1 1 1 1 9 0 0 0 0 0 0 0 0 0 0 0 0 0 0 0 0 0 0 0 0 0 0 0 0 0 0 0 0 0 0 0 0 0 0 8 1 1 1 1 1 1 1 1
52 1 1 1 1 1 1 1 1 9 0 0 0 0 0 0 0 0 0 0 0 0 0 0 0 0 0 0 0 0 0 0 0 0 0 0 0 0 0 0 0 0 0 0 8 1 1 1 1 1 1 1 1
52 1 1 1 1 1 1 1 1 9 0 0 0 0 0 0 0 0 0 0 0 0 0 0 0 0 0 0 0 0 0 0 0 0 0 0 0 0 0 0 0 0 0 0 8 1 1 1 1 1 1 1 1
52 1 1 1 1 1 1 1 1 9 0 0 0 0 0 0 0 0 0 0 0 0 0 0 0 0 0 0 0 0 0 0 0 0 0 0 0 0 0 0 0 0 0 0 8 1 1 1 1 1 1 1 1
52 1 1 1 1 1 1 1 1 9 0 0 0 0 0 0 0 0 0 0 0 0 0 0 0 0 0 0 0 0 0 0 0 0 0 0 0 0 0 0 0 0 0 0 8 1 1 1 1 1 1 1 1
52 1 1 1 1 1 1 1 1 9 0 0 0 0 0 0 0 0 0 0 0 0 0 0 0 0 0 0 0 0 0 0 0 0 0 0 0 0 0 0 0 0 0 0 8 1 1 1 1 1 1 1 1
52 1 1 1 1 1 1 1 1 9 0 0 0 0 0 0 0 0 0 0 0 0 0 0 0 0 0 0 0 0 0 0 0 0 0 0 0 0 0 0 0 0 0 0 8 1 1 1 1 1 1 1 1
52 1 1 1 1 1 1 1 1 9 0 0 0 0 0 0 0 0 0 0 0 0 0 0 0 0 0 0 0 0 0 0 0 0 0 0 0 0 0 0 0 0 0 0 8 1 1 1 1 1 1 1 1
52 1 1 1 1 1 1 1 1 9 0 0 0 0 0 0 0 0 0 0 5 2 6 0 0 0 0 0 0 0 0 0 0 0 0 0 0 0 0 0 0 0 0 0 8 1 1 1 1 1 1 1 1
52 1 1 1 1 1 1 1 1 4 2 2 2 6 0 0 0 0 0 0 8 9 0 0 0 0 0 0 0 5 2 2 6 0 0 0 0 0 0 0 0 0 0 0 8 1 1 1 1 1 1 1 1
52 1 1 1 1 1 1 1 1 9 31 33 35 0 0 0 0 0 0 0 8 9 0 0 0 0 0 0 0 0 0 8 4 6 0 0 0 0 0 0 0 0 0 0 8 1 1 1 1 1 1 1 1
52 1 1 1 1 1 1 1 1 9 32 34 36 0 0 0 0 0 0 0 8 9 0 0 0 0 0 0 0 0 0 8 1 4 2 2 2 6 0 0 0 0 0 0 8 1 1 1 1 1 1 1 1
52 1 1 1 1 1 1 1 1 9 0 0 0 0 0 0 0 0 0 0 8 4 6 0 0 0 0 0 0 0 0 8 1 1 1 1 1 4 6 0 0 0 0 0 8 1 1 1 1 1 1 1 1
52 1 1 1 1 1 1 1 1 9 0 0 0 0 0 0 0 0 0 0 8 9 0 0 0 0 0 0 0 5 2 3 1 1 1 1 1 1 4 6 0 0 0 0 8 1 1 1 1 1 1 1 1
52 1 1 1 1 1 1 1 1 9 0 0 0 0 0 0 0 0 0 0 8 9 0 0 0 0 0 0 0 0 32 10 0 0 0 10 0 0 0 41 0 0 0 0 8 1 1 1 1 1 1 1 1
52 1 1 1 1 1 1 1 1 9 0 0 0 0 0 0 0 0 0 0 8 9 0 0 0 0 0 0 0 0 0 10 0 0 0 0 0 0 0 0 0 0 0 0 0 0 0 0 0 0 0 0 0
52 1 1 1 1 1 1 1 1 9 0 0 0 0 0 0 0 0 0 0 8 9 0 0 0 0 0 0 42 0 0 10 0 0 0 0 0 0 0 0 0 0 0 0 0 0 0 0 0 0 0 0 0
52 1 1 1 1 1 1 1 1 4 2 2 2 2 2 2 2 2 2 2 3 4 24 24 24 24 24 24 24 24 2 7 2 2 2 2 24 24 24 2 2 2 2 2 2 2 2 2 2 2 2 2 2
52 1 1 1 1 1 1 1 1 1 1 1 1 1 1 1 1 1 1 1 1 1 1 1 1 1 1 1 1 1 1 1 1 1 1 1 1 1 1 1 1 1 1 1 1 1 1 1 1 1 1 1 1
52 1 1 1 1 1 1 1 1 1 1 1 1 1 1 1 1 1 1 1 1 1 1 1 1 1 1 1 1 1 1 1 1 1 1 1 1 1 1 1 1 1 1 1 1 1 1 1 1 1 1 1 1
