(None) mapchip\StageSetTile.png
128
64 34
34
64 0 0 0 0 0 0 0 0 0 0 0 0 0 0 0 0 0 0 0 0 0 0 0 0 0 0 0 0 0 0 0 0 0 0 0 0 0 0 0 0 0 0 0 0 0 0 0 0 0 0 0 0 0 0 0 0 0 0 0 0 0 0 0 0
64 1 1 1 9 0 0 0 0 0 0 0 0 0 0 0 0 8 1 1 1 1 9 0 0 0 0 0 0 0 8 1 1 1 1 1 1 9 0 0 0 0 0 0 0 0 0 0 0 0 0 0 0 0 0 8 1 1 1 1 1 1 1 1 0
64 1 1 1 9 0 0 0 0 0 0 0 0 0 0 0 0 8 1 1 1 1 9 0 0 0 0 0 0 0 8 1 1 1 1 1 1 9 0 0 0 0 0 0 0 0 0 0 0 0 0 0 0 0 0 8 1 1 1 1 1 1 1 1 0
64 1 1 1 9 0 0 0 0 0 0 0 0 0 0 0 0 8 1 1 1 1 9 0 0 0 0 0 0 0 8 1 1 1 1 1 1 9 0 0 0 0 0 0 0 0 0 0 0 0 0 0 0 0 0 8 1 1 1 1 1 1 1 1 0
64 1 1 1 9 0 0 0 0 0 0 0 0 0 0 0 0 8 1 1 1 1 9 0 0 0 0 0 0 0 8 1 1 1 1 1 1 9 0 0 0 0 0 0 0 0 0 0 0 0 0 0 0 0 0 8 1 1 1 1 1 1 1 1 0
64 1 1 1 9 0 0 0 0 0 0 0 0 0 0 0 0 8 1 1 1 1 9 0 0 0 0 0 0 0 8 1 1 1 1 1 1 9 0 0 0 0 0 0 0 0 0 0 0 0 0 0 0 0 0 8 1 1 1 1 1 1 1 1 0
64 1 1 1 9 0 0 0 0 0 0 0 0 0 0 0 0 8 1 1 1 1 9 0 0 0 0 0 0 0 8 1 1 1 1 1 1 9 0 0 0 0 0 0 0 0 0 0 0 0 0 0 0 0 0 8 1 1 1 1 1 1 1 1 0
64 1 1 1 9 0 0 0 0 0 0 0 0 0 0 0 0 8 1 1 1 1 9 0 0 0 0 0 0 0 8 1 1 1 1 1 1 9 0 0 0 0 0 0 0 0 0 0 0 0 0 0 0 0 0 8 1 1 1 1 1 1 1 1 0
64 1 1 1 9 0 0 0 0 0 0 0 0 0 0 0 0 8 1 1 1 1 9 0 0 0 0 0 0 0 8 1 1 1 1 1 1 9 0 0 0 0 0 0 0 0 0 0 0 0 0 0 0 0 0 8 1 1 1 1 1 1 1 1 0
64 1 1 1 9 0 0 0 0 0 0 0 0 0 0 0 0 8 1 1 1 1 9 0 0 0 0 0 0 0 8 1 1 1 1 1 1 9 0 0 0 0 0 0 0 0 0 0 0 0 0 0 0 0 0 8 1 1 1 1 1 1 1 1 0
64 1 1 1 9 0 0 0 0 0 0 0 0 0 0 0 0 8 1 1 1 1 9 0 0 0 0 0 0 0 8 1 1 1 1 1 1 9 0 0 0 0 0 0 0 0 0 0 0 0 0 0 0 0 0 8 1 1 1 1 1 1 1 1 0
64 1 1 1 9 0 0 0 0 0 0 0 0 0 0 0 0 8 1 1 1 1 9 0 0 0 0 0 0 0 8 1 1 1 1 1 1 9 0 0 0 0 0 0 0 0 0 0 0 0 0 0 0 0 0 8 1 1 1 1 1 1 1 1 0
64 1 1 1 9 0 0 0 0 0 0 0 0 0 0 0 0 8 1 1 1 1 9 0 0 0 0 0 0 0 8 1 1 1 1 1 1 9 0 0 0 0 0 0 0 0 0 0 0 0 0 0 0 0 0 8 1 1 1 1 1 1 1 1 0
64 1 1 1 9 0 0 0 0 0 0 0 0 0 0 0 0 8 1 1 1 1 9 0 0 0 0 0 0 0 8 0 0 0 0 0 0 9 0 0 0 0 0 0 0 0 0 0 0 0 0 0 0 0 0 8 1 1 1 1 1 1 1 1 0
64 1 1 1 9 0 0 0 0 0 0 5 2 2 2 2 2 3 1 1 1 1 9 0 0 0 0 0 0 0 8 0 0 0 0 0 0 9 0 0 0 0 0 0 0 0 0 0 0 0 0 0 0 0 0 8 1 1 1 1 1 1 1 1 0
64 1 1 1 4 2 6 0 0 0 0 8 0 0 0 0 0 1 1 9 0 8 9 0 0 0 0 0 0 0 8 2 2 2 2 6 0 9 0 0 0 0 0 0 0 0 0 0 0 0 0 0 0 0 0 8 1 1 1 1 1 1 1 1 0
64 1 1 1 9 0 0 0 0 0 0 8 0 0 0 0 0 1 1 4 2 3 4 2 2 6 0 0 0 0 8 0 0 0 0 10 0 9 0 0 0 0 0 0 0 0 0 0 0 0 0 0 0 0 0 8 1 1 1 1 1 1 1 1 0
64 1 1 1 9 0 0 0 0 0 0 8 2 2 2 6 0 1 1 1 1 1 9 0 0 0 0 0 0 0 8 0 0 0 0 10 0 9 0 0 0 0 0 0 0 0 0 0 0 0 0 0 0 0 0 8 1 1 1 1 1 1 1 1 0
64 1 1 1 9 0 0 0 0 0 0 0 33 35 8 9 0 1 9 0 8 1 9 0 0 0 0 0 0 0 8 0 5 2 2 9 0 9 0 0 0 0 0 0 0 0 0 0 0 0 0 0 0 0 0 8 1 1 1 1 1 1 1 1 0
64 1 1 1 9 0 0 0 0 0 0 0 34 36 8 0 0 1 4 2 3 1 9 0 0 0 0 0 0 0 8 0 8 1 1 9 0 4 6 0 0 0 0 0 0 0 0 0 0 0 0 0 0 0 0 8 1 1 1 1 1 1 1 1 0
64 1 1 1 9 0 0 14 14 0 0 0 0 0 8 2 2 1 1 1 1 1 9 0 0 0 0 0 5 2 3 2 3 1 1 4 2 1 9 0 0 0 0 0 0 0 0 0 5 6 0 0 0 0 0 8 1 1 1 1 1 1 1 1 0
64 1 1 1 9 0 0 0 0 0 0 0 0 0 0 0 0 0 0 0 31 35 0 0 0 0 0 0 10 0 8 1 9 0 8 1 1 1 9 0 0 0 0 0 0 0 0 0 8 9 0 0 0 0 0 8 1 1 1 1 1 1 1 1 0
64 1 1 1 9 0 0 0 0 0 0 0 0 0 0 0 0 0 0 0 32 36 0 0 0 0 0 0 8 2 3 1 4 2 3 1 1 1 9 0 0 0 0 0 0 0 0 0 0 9 0 0 0 0 0 0 0 0 0 0 0 0 0 0 0
64 1 1 1 4 2 24 24 24 24 24 24 24 24 24 24 2 2 6 0 0 0 0 0 0 0 0 0 0 0 0 0 0 0 0 0 0 41 10 0 0 0 0 0 0 0 0 0 0 9 0 0 0 0 0 0 0 0 0 0 0 0 0 0 0
64 1 1 1 1 1 1 1 1 1 1 1 1 1 1 1 1 1 4 2 6 0 0 0 0 0 0 0 0 0 0 0 0 0 0 0 0 0 10 0 0 0 5 2 2 24 24 24 3 4 2 2 2 2 2 2 2 2 2 2 2 2 2 2 0
64 1 1 1 1 1 1 1 1 1 1 1 1 1 1 1 1 1 1 1 4 24 24 24 24 24 24 24 2 2 2 2 2 2 6 0 0 0 8 2 2 2 3 0 0 0 0 0 0 8 1 1 1 1 1 1 1 1 1 1 1 1 1 1 0
64 0 0 0 0 0 0 0 0 0 0 0 0 0 0 0 0 1 1 1 1 1 1 1 1 1 1 1 1 1 1 1 1 1 4 6 0 0 0 0 0 35 33 0 0 0 0 0 0 8 1 1 1 1 1 1 1 1 1 1 1 1 1 1 0
64 0 0 0 0 0 0 0 0 0 0 0 0 0 0 0 0 0 0 1 1 1 1 1 1 1 1 1 1 1 1 1 1 1 9 0 0 0 0 0 0 36 34 0 0 0 0 10 0 8 9 0 0 0 8 1 1 1 1 1 1 1 1 1 0
64 0 0 0 0 0 0 0 0 0 0 0 0 0 0 0 0 0 0 0 0 0 0 0 0 0 0 0 0 0 0 0 1 1 9 0 0 0 0 0 0 0 0 0 0 0 0 10 0 10 0 0 0 0 8 1 1 1 1 1 1 1 1 1 0
64 0 0 0 0 0 0 0 0 0 0 0 0 0 0 0 0 0 0 0 0 0 0 0 0 0 0 0 0 0 0 0 1 1 9 0 0 0 0 0 0 0 0 0 0 0 0 0 0 0 0 0 5 2 3 1 1 1 1 1 1 1 1 1 0
64 0 0 0 0 0 0 0 0 0 0 0 0 0 0 0 0 0 0 0 0 0 0 0 0 0 0 0 0 0 0 0 1 1 4 6 42 0 0 0 0 0 0 0 0 0 0 0 0 0 0 5 3 1 1 0 0 0 0 0 0 0 0 0 0
64 0 0 0 0 0 0 0 0 0 0 0 0 0 0 0 0 0 0 0 0 0 0 0 0 0 0 0 0 0 0 0 1 1 1 4 2 2 2 2 2 2 2 2 2 2 2 2 2 2 2 3 1 1 1 0 0 0 0 0 0 0 0 0 0
64 0 0 0 0 0 0 0 0 0 0 0 0 0 0 0 0 0 0 0 0 0 0 0 0 0 0 0 0 0 0 0 0 1 1 1 1 1 1 1 1 1 1 1 1 1 1 1 1 1 1 1 1 0 0 0 0 0 0 0 0 0 0 0 0
64 0 0 0 0 0 0 0 0 0 0 0 0 0 0 0 0 0 0 0 0 0 0 0 0 0 0 0 0 0 0 0 0 0 1 1 1 1 1 1 1 1 1 1 1 1 1 1 1 1 1 1 0 0 0 0 0 0 0 0 0 0 0 0 0
