(None) mapchip\StageSetTile.png
128
62 26
26
62 1 1 1 1 1 1 1 1 9 0 0 0 0 0 0 0 0 0 0 0 8 1 9 0 0 0 0 0 0 0 0 10 0 0 0 0 0 0 0 0 0 0 0 0 0 0 0 0 0 0 8 1 1 1 1 1 1 1 1 0 0 0
62 1 1 1 1 1 1 1 1 9 0 0 0 0 0 0 0 0 0 0 0 8 1 9 0 0 0 0 0 0 0 0 10 0 0 0 0 0 0 0 0 0 0 0 0 0 0 0 0 0 0 8 1 1 1 1 1 1 1 1 0 0 0
62 1 1 1 1 1 1 1 1 9 0 0 0 0 0 0 0 0 0 0 0 8 1 9 0 0 0 0 0 0 0 0 10 0 0 0 0 0 0 0 0 0 0 0 0 0 0 0 0 0 0 8 1 1 1 1 1 1 1 1 0 0 0
62 1 1 1 1 1 1 1 1 9 0 0 0 0 0 0 0 0 0 0 0 8 1 9 0 0 0 0 0 0 0 0 10 0 0 0 0 0 0 0 0 0 0 0 0 0 0 0 0 0 0 8 1 1 1 1 1 1 1 1 0 0 0
62 1 1 1 1 1 1 1 1 9 0 0 0 0 0 0 0 0 0 0 0 8 1 9 0 0 0 0 0 0 0 0 10 0 0 0 0 0 0 0 0 0 0 0 0 0 0 0 0 0 0 8 1 1 1 1 1 1 1 1 0 0 0
62 1 1 1 1 1 1 1 1 9 0 0 0 0 0 0 0 0 0 0 0 8 1 9 0 0 0 0 0 0 0 0 10 0 0 0 0 0 0 0 0 0 0 0 0 0 0 0 0 0 0 8 1 1 1 1 1 1 1 1 0 0 0
62 1 1 1 1 1 1 1 1 9 0 0 0 0 0 0 0 0 0 0 0 8 1 9 0 0 0 0 0 0 0 0 10 0 0 0 0 0 0 0 0 0 0 0 0 0 0 0 0 0 0 8 1 1 1 1 1 1 1 1 0 0 0
62 1 1 1 1 1 1 1 1 9 0 0 0 0 0 0 0 0 0 0 0 8 1 9 0 0 0 0 0 0 0 0 10 0 0 0 0 0 0 0 0 0 0 0 0 0 0 0 0 0 0 8 1 1 1 1 1 1 1 1 0 0 0
62 1 1 1 1 1 1 1 1 9 0 0 0 0 0 0 0 0 0 0 0 8 1 9 0 0 0 0 0 0 0 0 10 0 0 0 0 0 0 0 0 0 0 0 0 0 0 0 0 0 0 8 1 1 1 1 1 1 1 1 0 0 0
62 1 1 1 1 1 1 1 1 9 0 0 0 0 0 0 0 0 0 0 0 8 1 9 0 0 0 0 0 0 0 0 10 0 0 0 0 0 0 0 0 0 0 0 0 0 0 0 0 0 0 8 1 1 1 1 1 1 1 1 0 0 0
62 1 1 1 1 1 1 1 1 9 0 0 0 0 0 0 0 0 0 0 0 8 1 9 0 0 0 0 0 0 0 0 10 0 0 0 0 0 0 0 0 0 0 0 0 0 0 0 0 0 0 8 1 1 1 1 1 1 1 1 0 0 0
62 1 1 1 1 1 1 1 1 9 0 0 0 0 0 0 0 0 0 0 0 8 1 9 0 0 0 0 0 0 0 0 10 0 0 0 0 0 0 0 0 0 0 0 0 0 0 0 0 0 0 8 1 1 1 1 1 1 1 1 0 0 0
62 1 1 1 1 1 1 1 1 9 0 0 0 0 0 0 0 0 0 0 0 0 0 0 0 0 0 0 0 0 0 0 10 0 0 0 0 0 0 0 0 0 0 0 0 0 0 0 0 0 0 8 1 1 1 1 1 1 1 1 0 0 0
62 1 1 1 1 1 1 1 1 9 0 0 0 0 0 0 0 0 0 0 0 5 2 6 14 0 0 0 0 0 0 0 10 0 0 0 0 0 0 0 0 0 0 0 0 0 0 0 0 0 0 8 1 1 1 1 1 1 1 1 0 0 0
62 1 1 1 1 1 1 1 1 9 0 0 0 0 0 0 14 0 0 0 0 8 1 9 0 0 0 0 0 0 0 0 10 0 0 0 0 15 16 0 0 0 0 0 0 0 0 0 0 0 0 8 1 1 1 1 1 1 1 1 0 0 0
62 1 1 1 1 1 1 1 1 9 0 0 0 0 0 0 13 0 0 0 0 8 1 9 0 0 0 14 0 0 0 14 10 0 0 0 0 41 0 0 0 0 0 0 0 0 0 0 0 0 0 8 1 1 1 1 1 1 1 1 0 0 0
62 1 1 1 1 1 1 1 1 9 0 0 0 0 0 0 5 2 2 24 24 3 1 9 0 0 0 0 0 0 0 35 10 0 0 0 0 0 0 0 0 0 0 0 0 0 0 0 0 0 0 8 1 1 1 1 1 1 1 1 0 0 0
62 1 1 1 1 1 1 1 1 9 0 0 15 16 0 0 0 0 0 0 0 0 8 9 0 0 0 0 0 0 0 36 10 0 14 0 0 0 0 0 0 0 0 0 0 0 0 0 0 0 0 8 1 1 1 1 1 1 1 1 0 0 0
62 1 1 1 1 1 1 1 1 9 0 0 0 0 0 0 0 0 0 0 0 0 8 4 24 26 0 0 0 0 0 0 10 0 0 0 0 0 25 26 0 0 0 0 0 0 16 14 0 0 0 8 1 1 1 1 1 1 1 1 0 0 0
62 1 1 1 1 1 1 1 1 9 0 0 0 0 0 0 0 0 0 0 0 0 0 8 1 9 0 0 0 0 0 0 0 0 0 0 0 0 0 0 0 0 0 0 0 0 0 0 0 0 0 0 0 0 0 0 0 0 0 0 0 0 0
62 1 1 1 1 1 1 1 1 9 15 16 0 0 15 16 0 0 0 0 0 0 0 0 8 9 0 0 0 0 0 0 0 0 0 0 0 0 0 0 0 0 0 0 0 0 0 0 0 0 0 0 0 0 0 0 0 0 0 0 0 0 0
62 1 1 1 1 1 1 1 1 9 33 31 0 0 0 0 0 0 0 0 0 0 0 0 8 4 2 24 24 24 24 24 24 24 24 24 24 24 24 24 24 24 24 24 24 24 24 24 24 24 24 2 2 2 2 2 2 2 2 2 0 0 0
62 1 1 1 1 1 1 1 1 9 42 32 0 0 0 0 0 0 0 0 0 0 0 0 8 1 1 1 1 1 1 1 1 1 1 1 1 1 1 1 1 1 1 1 1 1 1 1 1 1 1 1 1 1 1 1 1 1 1 1 0 0 0
62 1 1 1 1 1 1 1 1 4 2 2 2 2 2 2 2 2 2 2 2 2 2 2 3 1 1 1 1 1 1 1 1 1 1 1 1 1 1 1 1 1 1 1 1 1 1 1 1 1 1 1 1 1 1 1 1 1 1 1 0 0 0
62 1 1 1 1 1 1 1 1 1 1 1 1 1 1 1 1 1 1 1 1 1 1 1 1 1 1 1 1 1 1 1 1 1 1 1 1 1 1 1 1 1 1 1 1 1 1 1 1 1 1 1 1 1 1 1 1 1 1 1 0 0 0
62 1 1 1 1 1 1 1 1 1 1 1 1 1 1 1 1 1 1 1 1 1 1 1 1 1 1 1 1 1 1 1 1 1 1 1 1 1 1 1 1 1 1 1 1 1 1 1 1 1 1 1 1 1 1 1 1 1 1 1 0 0 0
